20 20
....................
....................
.......######.......
.......######...#...
.......######.......
.....#.######.......
...############.....
...############.....
.##################.
###################.
###################.
###################.
.##################.
.##################.
...##########.......
.....########.......
...##########.......
...##########.......
.....########.......
....#########.......
