********
***B****
**BRB***
***B****
********
********
********
********
